EA ./textures/east.xpm


WE ./textures/west.xpm
SO ./textures/south.xpm

NO ./textures/north.xpm
F 220,100,0
C 225,30,0

1111111111111111111111111
1111111111100011111111111
111111111110S011111111111
1111111111100011111111111
1111111111100011111111111
1111111111100011111111111
1111111111100011111111111
1111111111100011111111111
1111111111100011111111111
1111111111100011111111111
1111111111100011111111111
1111111111100011111111111
1111111111100011111111111
1111111111100011111111111
1111111111100011111111111
1111111111100011111111111
1111111111100011111111111
1111111111100011111111111
1111111111100011111111111
1111111111100011111111111
1111111111100011111111111
1111111111100011111111111
1111111111100011111111111
1111111111100011111111111
1111111111100011111111111
1111111111100011111111111
1111111111100011111111111
1111111111100011111111111
1111111111100011111111111
1111111111100011111111111
1111111111100011111111111
1111111111100011111111111
1111111111100011111111111
1111111111100011111111111
1111111111100011111111111
1111111111100011111111111
1111111111100011111111111
1111111111100011111111111
1111111111100011111111111
1111111111100011111111111
1111111111100011111111111
1111111111100011111111111
1111111111100011111111111
1111111111100011111111111
1111111111100011111111111
1111111111100011111111111
1111111111100011111111111
1111111111100011111111111
1111111111100011111111111
1111111111100011111111111
1111111111100011111111111
1111111111100011111111111
1111111111100011111111111
1111111111100011111111111
1111111111100011111111111
1111111111100011111111111
1111111111100011111111111
1111111111100011111111111
1111111111100011111111111
1111111111100011111111111
1111111111100011111111111
1111111111100011111111111
1111111111100011111111111
1111111111100011111111111
1111111111100011111111111
1111111111100011111111111
1111111111100011111111111
1111111111100011111111111
1111111111100011111111111
1111111111100011111111111
1111111111100011111111111
1111111111100011111111111
1111111111100011111111111
1111111111100011111111111
1111111111100011111111111
1111111111100011111111111
1111111111100011111111111
1111111111100011111111111
1111111111100011111111111
1111111111100011111111111
1111111111100011111111111
1111111111100011111111111
1111111111100011111111111
1111111111100011111111111
1111111111100011111111111
1111111111100011111111111
1111111111100011111111111
1111111111100011111111111
1111111111100011111111111
1111111111100011111111111
1111111111100011111111111
1111111111100011111111111
1111111111100011111111111
1111111111100011111111111
1111111111100011111111111
1111111111100011111111111
1111111111100011111111111
1111111111100011111111111
1111111111100011111111111
1111111111100011111111111
1111111111100011111111111
1111111111100011111111111
1111111111100011111111111
1111111111100011111111111
1111111111100011111111111
1111111111100011111111111
1111111111100011111111111
1111111111100011111111111
1111111111100011111111111
1111111111100011111111111
1111111111100011111111111
1111111111100011111111111
1111111111100011111111111
1111111111100011111111111
1111111111111111111111111