111111111111111
100000010000001
10011000010C101
1100E1010111101
111110010000001
100000010001001
101111111001001
100110000001001
110C1C1100010P1
111111111111111