111111111
101010001
101 10101
101100101
111111111
