111111111111111
1CCCCCCCCCCCCC1
1CCCCCCCCCCCCC1
11CCE1C1C1111C1
1CCCCCCCCCCCCC1
1CCCCCCCCCCCCC1
1CCCCCCCCCCCCC1
1CCCCCCCCCCCCC1
11CC1C11CCC1CP1
111111111111111