NO ./textures/north.xpm
EA ./textures/east.xpm
WE ./textures/west.xpm
SO ./textures/south.xpm

F 220,100,0
C 225,30,0

1111111111111111111111111
1100000000000000000000001
1000000000000000000000001
10000000000000000E0000001
1000000000000000000000001
1000000000000000000000001
1000000000000000000000001
1000000000000000000000001
1000000000000000000000001
1000000000000000000000001
1111111111111111111111111