NO ./textures/north.xpm
EA ./textures/east.xpm
WE ./textures/west.xpm
SO ./textures/south.xpm

F 128,47,191
C 0,00,0

1111111111111111111111111
1100000000001000100010001
1001010000100010001000001
1001010101000000000000001
1001010101000100E00000001
1001010101001010000000001
1000000101001010001110011
1000000101000000001100001
1111100000001011111101101
1111100000001000000000001
1111111111111111111111111