NO ./textures/north.xpm
EA ./textures/east.xpm
C 225,30,0
SO ./textures/south.xpm
F +159,+5,  +74
WE ./textures/west.xpm
1111111111111111111111111
1100000000011000000000001
1001100000111000000000001
10010000000000000W0000001
1011000001110000000000001
1111111111111111111111111