NO ./textures/north.xpm
EA ./textures/east.xpm
WE ./textures/west.xpm
SO ./textures/south.xpm

F 220,100,0
C 225,30,0

11111111111111111111111111111111111111111111111111
   1E00000000000000000000000000000000000000001
11111111111111111111111111111111111111111111111111