NO ./textures/f1/north.xpm
SO ./textures/f1/south.xpm
WE ./textures/f1/west.xpm
EA ./textures/f1/east.xpm

F 220,100,0
C 243,161,243

1111111111 1111111111
1000000001 1000000001
1000010001 1000100001
1000011111 1111100001
1000010001 1000100001
10000N0001 1000000001     
1011000001 1000001101     
1000000001 1000000001     
1111110001 1111111111
    100001 100001
    100001 100001
1111100011 1100011111   
1000000001 1000000001
1000111001 1001110001
11111 1111 1111 11111