NO ./textures/north.xpm
SO ./textures/south.xpm
WE ./textures/west.xpm
EA ./textures/east.xpm

F 220,100,0
C 225,30,0

1111
1001
1001111
1000001111
1000000001111
1000000000001111
1000000000000001111
10000000S00000000001111
10000000000000000000001111
10000000000000000000000001111
10000000000000000000000000001111
1000000000000 000000000000000001
11111111111111111111111111111111