NO ./textures/north.xpm
SO ./textures/south.xpm
WE ./textures/west.xpm
EA ./textures/east.xpm

F 220,100,0
C 225,30,0

1111111111111111111111111
1000000000110000000000001
1011000001110000E00000001
1001000000000000000000001
1011000001110000000000001
10000000001100000111011111
10001011011111000100000000
11110101111111000100101001
11000000110101000100000001
10000000000000000111100001
10000000000000000000001001
11000001110101011111111111
11110111 1110101
11111111 1111111