NO ./textures/north.xpm
SO ./textures/south.xpm
WE ./textures/west.xpm
EA ./textures/east.xpm

F 220,0,25
C 225,30,0

11111111111111111111111
10000000000E00000000001
10000000000000000000001
10001111111111111110001
10001             10001
10001111111111111110001
10000000000000000000001
10001111111111111110001
10001             10001
10001111111111111110001
10000000000000000000001
10000000000000000000001

11111111111111111111111