NO ./textures/north.xpm
SO ./textures/south.xpm
WE ./textures/west.xpm
EA ./textures/east.xpm

F 220,0,-100
C 225,30,125

1111111111
1000000001
1000010001
1000000001
1000000001
1000000001
10000N0001111111
1101100001000001
1000000000000001
1111111111111111