NO ./textures/north.xpm
SO ./textures/south.xpm
WE ./textures/west.xpm
EA ./textures/east.xpm

F 220,100,0
C 225,30,0

1111111111111      1111111111
10000000000011111111000000001
10000000000000000000000000001
10000000000001000000000000001
10000000000000000000000000001
10000000000000000000001000001
10000000000000000000000000001
10000001000000000000000000001
10000000000000000000000000001
11111111111111111111111111111