NO ./textures/north.xpm
SO ./textures/south.xpm
WE ./textures/west.xpm
EA ./textures/east.xpm

F 220,100,0
C 225,30,0

111111111111111111111111111111111
100000000000000000010000000000001
111111111000000000010000000000001
        1000000000000000000000001
111111111111000000010000000000001
100000000000000001110111111111111
101101111011110111000000100000001
111101111111110100000100100000001
110000001101010111000100000000001
100000000000000011000100100000001  W
100000000000000011000000100000001
110000011101010111110111100011111
10000111 1110101 1000000000000001
11111111 1111111 1111111111111111