NO ./textures/north.xpm
SO ./textures/south.xpm
WE ./textures/west.xpm
EA ./textures/east.xpm

F 220,100,0
C 225,30,0

1111111111111      1111111111
10000000000011111111000000001
1000E000000000000000000000001
10000000001111111100000000001
10000000001000000100000000001
1000000000100E000100001000001
10000000001000000100000000001
10000001001000000100000000001
10000000000000000100000000001
11111111111111111111111111111