111111111111111
10000000000001
1000E0000000001
100000000001
1000C0000000001
100000000000001
10000000
1000P0000000001
10000000000001
111111111111111