111111111111111
100000000000001
1000000000W0001
100000000000001
100000000000001
100000000000001
100000000000001
100000000100001
101001001 10001
11 11 11   1111