111111111111111
100000000000001
100P00000000001
100000000000001
100000000000001
100000000000000
100000000000001
10000C000000001
1000000000E0001
111111111111111