111111111111111
100000000000001
10000000000C001
1000P0000000001
100000000000001
100000000E00001
100000000000001
10C000000000001
10000000C0000P1
111111111111111