111111111111111
100000000000001
10001000000C001
1001E1000000001
100010000000001
100000000000001
100000000000001
10C000000000001
10000001C1000P1
111111111111111