1111111111111111111111111
1100000000011000000100001
1001100000111000000000001
1001000000000000000000001
1011000001110000000000001
1111111111111111111111111