1111111111111111111111111
1001010001000000001100001
1100010000011000000100011
10011 1000011100001 10001
1001010001000000001100001
10110000011110000W0000001
1111111111111111111111111