NO ./textures/north.xpm
SO ./textures/south.xpm
WE ./textures/west.xpm
EA ./textures/east.xpm

F 220,100,0
C 225,30,0

1111111111111111111
1                 111111111
1                         1
1   1111111111   W        1
1          1         111111
1          1         1    1
111111     1    111111    1
     1     1              1
     1     1              1
     1     11111111111   11
     1                    1
     1111111111111111111111