NO ./textures/north.xpm
SO ./textures/south.xpm
WE ./textures/west.xpm
EA ./textures/east.xpm

F 220,100,0
C 225,30,0

1111111111111111111111111
100000000011000000000000111111
101100000111000000000000000001
100100000000000000000000111111
1011000001110000000000001
100000000011000001110111111111
111101111111110011100000010001
111101111111110011101010010001
110000001101010011100000010001
100000000000000001100000010001
100000000000000001101010010001
110000011101010111111011110N01
11110111 1110101 1011110100011
11111111 1111111 111111111111
