ON ./textures/north.xpm
SO ./textures/south.xpm
WE ./textures/west.xpm
EA ./textures/east.xpm

F 220,100,0
C 225,30,0

1111111111111      1111111111
1000000000001      1000000001
1000100000001      1000000001
100S100000001      1000000001
1111100100001      1000000001
1000000100001      1111110001
1000000100001      1000000001
10000001000011111111000000001
10000001000000000000000000001
11111111111111111111111111111
