NO ./textures/north.xpm
SO ./textures/south.xpm
WE ./textures/west.xpm
EA ./textures/east.xpm

F 220+,100,0
C 225,30,0

1111111111111111111111111
1100000000011000000000001
1001100000111000000000001
10010000000000W0000000001
1011000001110000000000001
1111111111111111111111111