NO ./textures/north.xpm
SO 
WE ./textures/west.xpm
EA ./textures/east.xpm

F 220,100,0
C 225,30,0

1111111111111111111111111
1100000000011000000000001
1001100000111000000000001
1001000000000000W00000001
1011000001110000000000001
1111111111111111111111111