NO ./textures/north.xpm
SO ./textures/south.xpm
WE ./textures/west.xpm
EA ./textures/east.xpm

F 220,100,0
C 225,30,0

1111111111111111111111111
1100000000011000000000001
1001100000111000000000001
1001000000000000000000001
1011000001111 100W0000001
1111111111111 11111111111